BUBBL3 B4TTL3FI3LD#Bubble McGee:)
---------------------------------
@@@@@@@@@@@@@@@@@@@@@@@@@@@@@@@@@
        @@@@@@@@@@@@@@@@@        
         I     I I     I         
         I     I I     I         
@@       I     I I     I       @@
@@@@@@@@ I  O  I I     I @@@@@@@@
@@@@@@@@@@@    I I    @@@@@@@@@@@
@@@@@@@@@@@   @@@@@   @@@@@@@@@@@
@@@@@@@@@@@@   I I   @@@@@@@@@@@@
@@@@@@@@@@@@@@@I I@@@@@@@@@@@@@@@
@@@@@@@@@@@@@@@@@@@@@@@@@@@@@@@@@
@@@@@@@@@@@@@@@@@@@@@@@@@@@@@@@@@
---------------------------------
@@@@@@@@@@@@@@@@@@@@@@@@@@@@@@@@@
@@ F   @@@@@@@@@@@@@@@@@@@@@@@   
   F   F  .@@@   @@@  @@@@@ .    
   F   F  .  F  O           .    
@@@@@@ F  .  F              . @@@
@@@@@@@@@@.@@@@@   @@@@   @@.@@@@
@@@@@@@@@@.@@@@@ @ @@@@ @ @@.@@@@
@@@@@@@@@@.vvvvv...vvvv...vv.@@@@
@@@@@@@@@@...................@@@@
@@@@@@@@@@@@@@@@...@@@@...@@@@@@@
@@@@@@@@@@@@@@@@XmX@@@@XmX@@@@@@@
@@@@@@@@@@@@@@@@@@@@@@@@@@@@@@@@@
---------------------------------
@@@@@@@@@@@@@@@@@@@@@@@@@@@@@@@@@
@@@@@@@@@@@@@@@@@@@@@@@@@@@@@@@@@
@@@     F F@@  F  @@  F   F @@@  
@@F O   F F    F      F   F  F@  
  F    @@@F  @@@      F   F  F  @
@@F     F F    F  @@@ F @@F  F  @
@@@@@@@@F F    F @@   F   F @@@@@
@@@@@@@@@@@@@  F    @@@@@@@@@@@@@
@@@@@@@@@@@@@m F  @@@@@@@@@@@@@@@
@@@@@@@@@@@@@@@@@@@@@@@@@@@@@@@@@
@@@@@@@@@@@@@@@@@@@@@@@@@@@@@@@@@
@@@@@@@@@@@@@@@@@@@@@@@@@@@@@@@@@
---------------------------------
@@@@@@@@@@@@@@@@@@@@@@@@@@@@@@@@@
@         @@@@   @@@@@@@@@@@@@@@@
   Q  Q                    @@@@@@
   @@@@ Q                     F@@
@    @@@@    Q           O    F  
@@          @@                F @
@@              Q           @@@@@
@@@@@@@@@@@@@@@@@   Q       @@@@@
@@@@@@@@@@@@@@@@@   @@@@     @@@@
@@@@@@@@@@@@@@@@    @@@@@   @@@@@
@@@@@@@@@@@@@@@@@@  @@@@@@  @@@@@
wwwwwwwwwwwwwwwwwwwwwwwwwwwwwwwww
---------------------------------
@@@@@@@@@@@@@@@@@@@@@@@@@@@@@@@@@
@@@@@@@@@@fffff                @@
@@@@@@@  ffffff     @@           
@@@@@@@ @@@ffff   O              
@@@@@@@ @@@@@@@@              @@@
  @@@@@ @@@@@@        m@@@@   @@@
   fff   ffff       @  fff    @@@
@@@@@@@XX@@@@@   @@@@@@@@@@@@m@@@
@@@@@@@@@@@@@@m@@@@@@@@@@@@@@@@@@
@@@@@@@@@@@@@@@@@@@@@@@@@@@@@@@@@
@@@@@@@@@@@@@@@@@@@@@@@@@@@@@@@@@
@@@@@@@@@@@@@@@@@@@@@@@@@@@@@@@@@
---------------------------------
@@@@@@@@@@@@@@@@@@@@@@@@@@@@@@@@@
                O      F F     @@
                       F F     @@
                       F F      @
^^^^^^^^^^^^^^^^^^^^^^@@@@@     @
EEEEEEEEEEEEEEEEEEEEEE@@@@@@@@   
EEEEEEEEEEEEEEEEEEEEEEEEE@@@@@@  
EEEEEEEEEEEEEEEEEEEEEEEEEEEEE@@@@
EEEEEEEEEEEEEEEEEEEEEEEEEEEEEE@@@
EEEEEEEEEEEEEEEEEEEEEEEEEEEEEEE@@
EEEEEEEEEEEEEEEEEEEEEEEEEEEEEEE@@
EEEEEEEEEEEEEEEEEEEEEEEEEEEEEEE@@
---------------------------------