CL4551C#-original-
---------------------------------
@@@@@@@@@@@@@@@@@@@@@@@@@@@@@@@@@
@@@@@@@@@@@@@@@@@@@@@@@@@@@@@@@@@
                _              # 
       #        C    #           
 #         #              #      
   G   #           #         G   
@@@@@@        #         #  @@@@@@
@@@@@@@@@@@@@@@@@@@@@@@@@@@@@@@@@
@@@@@@@@@@@@@@@@@@@@@@@@@@@@@@@@@
@@@@@@@@@@@@@@@@@@@@@@@@@@@@@@@@@
@@@@@@@@@@@@@@@@@@@@@@@@@@@@@@@@@
@@@@@@@@@@@@@@@@@@@@@@@@@@@@@@@@@
---------------------------------
@@@@@@@@@@@@@@@@@@@@@@@@@@@@@@@@@
@H  ISSSSSSSSSSSI #IHHHI  IHHI  H
@H# ISPPPPPPPPPSI# I@@@I# IHHI# H
@H  ISPPPPPPPPPSI @@@@@@@ IHHI #H
@H  ISSSSSSSSSSSI#@@@@@@@#IHHI# H
HH #IHHHHHHHHHHHI  IHHHI# IHHI  H
@@@@@@@@@@@@@@@@@@@@@@@@@@@@@@@@@
@@@@@@@@@@@@@@@@@@@@@@@@@@@@@@@@@
@@@@@@@@@@@@@@@@@@@@@@@@@@@@@@@@@
@@@@@@@@@@@@@@@@@@@@@@@@@@@@@@@@@
@@@@@@@@@@@@@@@@@@@@@@@@@@@@@@@@@
@@@@@@@@@@@@@@@@@@@@@@@@@@@@@@@@@
---------------------------------
@@@==   A  ==@@@@@@@@@@@@@@@@@@@@
@@====     ===@@ | | @@@@@= |= =@
@@ =       = = = |    | |   | ==@
@@ ==   A             |     |  @@
@@      =     @@      | |   |  @@
==   A  =  A  @@  |   | |   |   =
@@@@@@@@@@@@@ @@ @@@ @@ @@ @@@@@@
@@@@@@@@@@@@@ @@ @@@ @@ @@ @@@@@@
@@@@@@@@@@@@@    @@@ @@ @@ @@@@@@
@@@@@@@@@@@@@@@@X@@@X@@X@@X@@@@@@
@@@@@@@@@@@@@@@@@@@@@@@@@@@@@@@@@
@@@@@@@@@@@@@@@@@@@@@@@@@@@@@@@@@
---------------------------------
@@@@@@@@@@@@@@@@@@@@@@@@@@@@@@@@@
@@@@@@@@@@@@@@@@@@@@@@@@@@@@@@@@@
ff    f f # ff    f    f f#   f @
@f   #f f   ff#   f  # f f    f @
@f    f f   ff    f    f#f    f @
ff  Y f f   ff  N f    f f  L f f
@@@@@@@@m@@@@@@@m@@@@@@@m@@@@@@@@
@@@@@@@@@@@@@@@@@@@@@@@@@@@@@@@@@
@@@@@@@@@@@@@@@@@@@@@@@@@@@@@@@@@
@@@@@@@@@@@@@@@@@@@@@@@@@@@@@@@@@
@@@@@@@@@@@@@@@@@@@@@@@@@@@@@@@@@
@@@@@@@@@@@@@@@@@@@@@@@@@@@@@@@@@
---------------------------------
                             @@@@
                                @
                                f
  QQ                           @@
@@@@@  Q  Q        Q   QQ      @@
@@@@@-@@@@@  Q    @@@@@@@@@   Q f
@@@@--@@@@@@@@@   @@@@@@@@@-@@@@@
@@ :    :  @@@@    : @@@@@--@@@@@
@  :    :   :      :        @@@@@
@  :    :    :     :        :  @@
@  :    :s  t:TtTtT:t  s    :   @
WWWWWWWWWWWWWWWWWWWWWWWWWWWWWWWWW
---------------------------------
                                 
                                 
                                 
                                 
                                 
                                 
^^^^^^^^^^^^^^^^^^^^^^^^^^^@@@@@@
EEEEEEEEEEEEEEEEEEEEEEEEEEE@@@@@@
EEEEEEEEEEEEEEEEEEEEEEEEEEE@@@@@@
EEEEEEEEEEEEEEEEEEEEEEEEEE@@@@@@@
EEEEEEEEEEEEEEEEEEEEEEEEEE@@@@@@@
EEEEEEEEEEEEEEEEEEEEEEEEE@@@@@@@@
---------------------------------