C0MB4T C4V3RN5#-original-
---------------------------------
vvvv@@@v@vv@@@@@@@@@vv@@v@@v@@v@ 
    vvv v  vvv@v@vvv  vv vv vv v 
              v v                
          ~~                     
 * ~     ~~~                 *  @
@@@~     ~~~        ~~~~    @@@@@
@@v~@@   ~~~        ~~~~ @@ v@@@@
@v ~vv  @@~~@@@@@@@ ~@@~ vv  v@@v
v  ~    vv~~v@@@@@v ~vv~      vv 
   ~      ~~ v@@@v  ~  ~         
   ~      ~~  v@v   ~  ~        w
wwwwwwwwwwwwwwwwwwwwwwwwwwwwwwww@
---------------------------------
@@@@vvvv@@@@vv@@@vv@@@@vvvvv@@@@v
vvvv    vvvv  v@v  v@@v     vvv@ 
F              v    vv   ~     v 
F             ~~~   *    ~       
F   *~ @@@@   ~~~   @@@@@~       
F  @@~ vvvv@@@X~X@@@vvvvv~ @@@@@@
@@@@@~     vvvv~vvvv     ~ @@@@@@
@@@@@wwwwwwwwwwwwwwwwwwwwww@@@@@@
@@@@@wwwwwwwwwwwwwwwwwwwwww@@@@@@
@@@@@@wwwwwwwwwwwwwwwwwwww@@@@@@@
@@@@@@wwwwwwwwwwwwwwwwwwww@@@@@@@
@@@@@@wwwwwwwwwwwwwwwwwwww@@@@@@@
---------------------------------
vv FF  vv@@@@vv F v@vv@@@@@vvv@@v
F  FF   Fvv@v   F  v  F@vvv F vv 
F  FF   F  F    F     Fv    F    
F  FF   F  F    F     F     F    
F+ FF*  F  F    F*    F     F   @
@@@FF+  F  F+   F    +F     F++ @
@@@@@@++F  @@  +F+   @@  + +@@@@@
@@@@@@@@@  @@  @@@@  @@  @@@@@@@@
@@@@@@@@@  @@  @@@@  @@  @@@@@@@@
@@@@@@@@@mm@@mm@@@@mm@@mm@@@@@@@@
@@@@@@@@@@@@@@@@@@@@@@@@@@@@@@@@@
@@@@@@@@@@@@@@@@@@@@@@@@@@@@@@@@@
---------------------------------
@@@@@@@@@@@@@@@@@@@@v        v@@@
@@@@@@@@@@@@@@vvvvvv   O      Fv@
@@@@@@@vvvvvvv                F v
vvvvvvv           *       F   F  
               @@@@       F F F  
        @@@@@@@@@@v      @@@@@@@@
@@@@@@@@@@@@@@@@vv       v@@@@@@@
@@@@@@@@@@@@@@@v          vv@@@@@
@@@@@@@@@@@@@@v^^^^^^^^^^^^^v@@@@
@@@@@@@@@@@@@vEEEEEEEEEEEEEEEv@@@
@@@@@@@@@@@@vEEEEEEEEEEEEEEEEE@@@
@@@@@@@@@@@vEEEEEEEEEEEEEEEEEEE@@
---------------------------------