5W0RD5K3T8R4WL#-original-
---------------------------------
@@@@@@@@@@@@@@@@@@@@@@@@@@@@@@@@@
@@@@@@@c@@@c@@@c@@@c@@@c@@@@@@@@@
@@ii  l  iiiiiiiiiiiii  l  ii@@@@
@iiii   iiiiiiiiiiiiiii   iiii@@@
iimiiiiiiiiiiiiiiiiiiiiiiiiimii@@
22@`````@m```````````m@`````@11@@
!!@ZZZZZZZZZ@@ZZZ@@ZZZZZZZZZ@!!@@
@ZZZZZZZZZZZZZZZZZZZZZZZZZZZZZ@@@
@mmmmmm!@@@@@@@@@@@@@@@!mmmmmm@@@
@@@@@@@@@@@@@@@@@@@@@@@@@@@@@@@@@
@@@@@@@@@@@@@@@@@@@@@@@@@@@@@@@@@
@@@@@@@@@@@@@@@@@@@@@@@@@@@@@@@@@
---------------------------------