TH3 B1G 5T1NKY#
---------------------------------
@@@@@@@@@@@@@@@@@@@@@@@@@@@@@@@@@
@@@@@@@@@@@@@|ZZZZZ|@@@@@@@@@@@@@
@@@@@@@@@@@@c|ZZZZZ|c@@@@@@@@@@@@
xx#xx | ()#|Z|@@@@@|Z|#() | xx#xx
xx xx#| ~~ |Z|@@@@@|Z| ~~ |#xx xx
xx xx |#~~ |Z|ZZZZZ|Z| ~~#| xx xx
@@@@@@@@~~@|Z|@@@@@|Z|@~~@@@@@@@@
@@@@@@@@~~@|Z|@@@@@|Z|@~~@@@@@@@@
@@@@@@@@~~@@@@@@@@@@@@@~~@@@@@@@@
@@@@@@@@ww@www@@@@@www@ww@@@@@@@@
wwwwwwwwwwwwwwwwwwwwwwwwwwwwwwwww
wwwwwwwwwwwwwwwwwwwwwwwwwwwwwwwww
---------------------------------
@@@@@@@@@@@@@@@@@@@@@@@@@@@@@@@@@
@@@@@@@   # @@@@@@@@@@@@@@@@@@@@@
@@@@@  u   u #@@@@@@@@@@@@@@@@@@@
 @@@ # ~#  ~   @@@@@@@@@@@@@@@@ #
  #    ~ # ~  # xx@@@@@@@@@@xx # 
#   #  ~   ~#   xx @@@@@@@@#xx  #
@@@@@@@~ @ ~@@@@@@   #xx  # @@@@@
@@@@@@@~  #~@@@@@@@  qxxq  @@@@@@
@@@@@@@~#  ~@@@@@@@@@@@@@@@@@@@@@
@@@@@@@wwwww@@@@@@@@@@@@@@@@@@@@@
wwwwwwwwwwwwwwwwwwwwwwwwwwwwwwwww
wwwwwwwwwwwwwwwwwwwwwwwwwwwwwwwww
---------------------------------
@@@@@@@@@@@@@@@@@@@@@@@@@@@@@@@@@
@@@@@@@@@@@@@@@@@@@@@@@@@@@@@@@@@
@@@@@@@@@@@@@@@@@@@@@@@@@@@@@@@@@
#        @@@  #xx   @@@# #       
   #     x xq  xx# qxKx         #
      #  x x  qxxq  x x    #     
@@@@@@@@@@K@@@@@@@@@@ @@@@@@@@@@@
@@@@@@@@@@#@@@@@@@@@@#@@@@@@@@@@@
@@@@@@@@@@m@@@@@@@@@@m@@@@@@@@@@@
@@@@@@@@@@@@@@@@@@@@@@@@@@@@@@@@@
wwwwwwwwwwwwwwwwwwwwwwwwwwwwwwwww
wwwwwwwwwwwwwwwwwwwwwwwwwwwwwwwww
---------------------------------
@@@@@@@@@@@@@@@@@@@@@@@@@@@@@@@@@
@@@@@@@@@@@@@   x    x   @@@@@@@@
@@@@@@.   x x  @@@()@@@  x x   @@
@@@@@@@   x xu @@@~~@@@ ux x     
   @@@@   @ x~  x ~~ x  ~x @     
@@      uu@ @@@@@ ~~ @@@@@ @uu   
@@@@@@@@~~@ @@@@@ ~~ @@@@@ @~~@@@
@@@@@@@@~~@ x~  x ~~ x  ~x @~~@@@
@@@@@@@@~~@@@@@@@@~~@@@@@@@@~~@@@
@@@@@@@@ww@@@@@@@@ww@@@@@@@@ww@@@
@@@@@@@@wwwwwwwwwwwwwwwwwwwwwwwww
@@@wwwwwwwwwwwwwwwwwwwwwwwwwwwwww
---------------------------------
@@@@@@@@@@@@@@@@@@@@@@@@@@@@@@@@@
@@@@@@@@@@@@@@@@@@@@@@@@@@@@@@@@@
@@@@@@@@@@@@@@@@@@@@@@@@@@@@@@@@@
                                @
                                 
                          @@@@@@@
                          @@@@@@@
                          @@@@@@@
^^^^^^^^^^^^^^^^^^^^^^^^^^@@@@@@@
EEEEEEEEEEEEEEEEEEEEEEEEEE@@@@@@@
EEEEEEEEEEEEEEEEEEEEEEEEEE@@@@@@@
EEEEEEEEEEEEEEEEEEEEEEEEEE@@@@@@@
---------------------------------