OmniSkill#Laminor
---------------------------------
@@@@@@@@@@@@@@@@@@@@@@@@@@@@@@@@@
@@@@@@@@@@@@@@@@@@@@@@@@@@@@@@@@@
@@@@@@@@@@@@@@@@@@@@@@@@@@@@@@@@@
                                 
@@@@ @@@@@@@@@@@@@@@@@@@@@@@ @@@@
@@@@ @@@@vv@@@@@vv@@@@@@@@@@ @@@@
                                 
@@@@@@@@@mm@@@@@mm@@@@@@@@@@@@@@@
@@@@@@@@@@@@@@@@@@@@@@@@@@@@@@@@@
@@@@@@@@@@@@@@@@@@@@@@@@@@@@@@@@@
@@@@@@@@@@@@@@@@@@@@@@@@@@@@@@@@@
@@@@@@@@@@@@@@@@@@@@@@@@@@@@@@@@@
---------------------------------
@@@@@@@@@@@@@@@@@@@@@@@@@@@@@@@@@
        @@@@@@@@@@@@@@@@@        
         I     I I     I         
         I     I I     I         
@@       I     I I     I       @@
@@@@@@@@ I  O  I I     I @@@@@@@@
@@@@@@@@@@@    I I    @@@@@@@@@@@
@@@@@@@@@@@   @@@@@   @@@@@@@@@@@
@@@@@@@@@@@@   I I   @@@@@@@@@@@@
@@@@@@@@@@@@@@@wmw@@@@@@@@@@@@@@@
@@@@@@@@@@@@@@@@@@@@@@@@@@@@@@@@@
@@@@@@@@@@@@@@@@@@@@@@@@@@@@@@@@@
---------------------------------
@@@@@@@@@@@@@@@@@@@@@@@@@@@@@@@@@
        @@@@@@@@@@@@@@@@@        
         I     I I     I         
         I     I I     I         
@@       I     I I     I       @@
@@@@@@@@ I  O  I I     I @@@@@@@@
@@@@@@@@@@@    I I    @@@@@@@@@@@
@@@@@@@@@@@   @@@@@   @@@@@@@@@@@
@@@@@@@@@@@@   I I   @@@@@@@@@@@@
@@@@@@@@@@@@@@@ImI@@@@@@@@@@@@@@@
@@@@@@@@@@@@@@@w@w@@@@@@@@@@@@@@@
@@@@@@@@@@@@@@@@@@@@@@@@@@@@@@@@@
---------------------------------
@@@@@@@@@@@@@@@@@@@@@@@@@@@@@@@@@
        @@@@@@@@@@@@@@@@@        
         I     I I     I         
         I     I I     I         
@@       I     I I     I       @@
@@@@@@@@ I  O  I I     I @@@@@@@@
@@@@@@@@@@@    I I    @@@@@@@@@@@
@@@@@@@@@@@   @@@@@   @@@@@@@@@@@
@@@@@@@@@@@@   I I   @@@@@@@@@@@@
@@@@@@@@@@@@@@@ImI@@@@@@@@@@@@@@@
@@@@@@@@@@@@@@@w@w@@@@@@@@@@@@@@@
@@@@@@@@@@@@@@@@@@@@@@@@@@@@@@@@@
---------------------------------
@@@@@@@@@@@@@@@@@@@@@@@@@@@@@@@@@
        @@@@@@@@@@@@@@@@@        
         I     I I     I         
         I     I I     I         
@@       I     I I     I       @@
@@@@@@@@ I  O  I I     I @@@@@@@@
@@@@@@@@@@@    I I    @@@@@@@@@@@
@@@@@@@@@@@   @@@@@   @@@@@@@@@@@
@@@@@@@@@@@@   I I   @@@@@@@@@@@@
@@@@@@@@@@@@@@@ImI@@@@@@@@@@@@@@@
@@@@@@@@@@@@@@@w@w@@@@@@@@@@@@@@@
@@@@@@@@@@@@@@@@@@@@@@@@@@@@@@@@@
---------------------------------
@@@@@@@@@@@@@@@@@@@@@@@@@@@@@@@@@
        @@@@@@@@@@@@@@@@@        
         I     I I     I         
         I     I I     I         
@@       I     I I     I       @@
@@@@@@@@ I  O  I I     I @@@@@@@@
@@@@@@@@@@@    I I    @@@@@@@@@@@
@@@@@@@@@@@   @@@@@   @@@@@@@@@@@
@@@@@@@@@@@@   I I   @@@@@@@@@@@@
@@@@@@@@@@@@@@@^^^@@@@@@@@@@@@@@@
@@@@@@@@@@@@@@@@@@@@@@@@@@@@@@@@@
@@@@@@@@@@@@@@@@@@@@@@@@@@@@@@@@@
---------------------------------
