Generated#BipBop
---------------------------------
@@@@    @@    @@@   @    @       
@   @ @   @  @   @          @@@  
             @     @ @ @@  @@   @
@  @ @   @   @  @   @ @ @ @@ @@  
  @@@@ @@@ @@   @@  @    @@@ @  @
@@@@ @        @@ @ @@@@    @ @  @
   @ @@@ @      @   @@@@      @  
            @   @ @@ @   @@ @ @ @
   @   @     @   @@     @ @ @   @
 @        @@           @  @   @@ 
  @@@ @ @@  @@@ @   @    @  @@@@@
 @  @@@  @   @    @   @     @@ @
---------------------------------
@@@@@@@@@@@@@@@@@@@@@@@@@@@@@@@@@
@@@@@@@@@@@@@@@@@@@@@@@@@@@@@@@@@
                                 
                                 
                                 
                                 
                                 
                                 
@@@@@@@@@@@@@@@@@@@@@@@@@@@@@@@@@
@@@@@@@@@@@@@@@@@@@@@@@@@@@@@@@@@
@@@@@@@@@@@@@@@@@@@@@@@@@@@@@@@@@
@@@@@@@@@@@@@@@@@@@@@@@@@@@@@@@@@
---------------------------------
@@@@@@@@@@@@@@@@@@@@@@@@@@@@@@@@@
@@@@@@@@@@@@@@@@@@@@@@@@@@@@@@@@@
                                 
                                 
                                 
                                 
                                 
                                 
@@@@@@@@@@@@@@@@@@@@@@@@@@@@@@@@@
@@@@@@@@@@@@@@@@@@@@@@@@@@@@@@@@@
@@@@@@@@@@@@@@@@@@@@@@@@@@@@@@@@@
@@@@@@@@@@@@@@@@@@@@@@@@@@@@@@@@@
---------------------------------
@@@@@@@@@@@@@@@@@@@@@@@@@@@@@@@@@
@@@@@@@@@@@@@@@@@@@@@@@@@@@@@@@@@
                                 
                                 
                                 
                                 
                                 
                                 
@@@@@@@@@@@@@@@@@@@@@@@@@@@@@@@@@
@@@@@@@@@@@@@@@@@@@@@@@@@@@@@@@@@
@@@@@@@@@@@@@@@@@@@@@@@@@@@@@@@@@
@@@@@@@@@@@@@@@@@@@@@@@@@@@@@@@@@
---------------------------------
@@@@@@@@@@@@@@@@@@@@@@@@@@@@@@@@@
@@@@@@@@@@@@@@@@@@@@@@@@@@@@@@@@@
                                 
                                 
                                 
                                 
                                 
                                 
@@@@@@@@@@@@@@@@@@@@@@@@@@@@@@@@@
@@@@@@@@@@@@@@@@@@@@@@@@@@@@@@@@@
@@@@@@@@@@@@@@@@@@@@@@@@@@@@@@@@@
@@@@@@@@@@@@@@@@@@@@@@@@@@@@@@@@@
---------------------------------
@@@@@@@@@@@@@@@@@@@@@@@@@@@@@@@@@
@@@@@@@@@@@@@@@@@@@@@@@@@@@@@@@@@
                                 
                                 
                                 
                                 
                                 
                                 
^^^^^^^^^^^^^^^^^^^^^^^@@@@@@@@@@
EEEEEEEEEEEEEEEEEEEEEEEE@@@@@@@@@
EEEEEEEEEEEEEEEEEEEEEEEEEE@@@@@@@
EEEEEEEEEEEEEEEEEEEEEEEEEEEE@@@@@
---------------------------------
