Hand Master#Laminor
---------------------------------
@@@@@@@@@@@@@@@@@@@@@@@@@@@@@@@@@
  @@@   @@@@@@@@@@@@@@@@@   @@@  
   @           @@@           @   
   c            @            c   
                l            c   
         @@@         @@@         
               @@@               
@@                             @@
@@@@X@@@@@@@@       @@@@@@@@X@@@@
@@@@@@@@@@@@@@@@X@@@@@@@@@@@@@@@@
@@@@@@@@@@@@@@@@@@@@@@@@@@@@@@@@@
@@@@@@@@@@@@@@@@@@@@@@@@@@@@@@@@@
---------------------------------
@@@@@@@@@@@@@@@@@@@@@@@@@@@@@@@@@
@@@@@@@@@@@@@@@@@@@@@@@@@@@@@@@@@
    @@@@@@@@@@@@@@@@@@@@@@@@@@@@@
@@  @@@@@@@@@@@@@@@@@@@@@@@@@@@@@
@  @@@    @@@@@@    @@@@@@    @@@
@@ @        @@        @@        @
@@                               
@@          @@        @@        @
@@@@@@    @m@@@@    @@@@@@    @m@
@@@@@@@@@@@@@@@@@mm@@@@@@@@@@@@@@
@@@@@@@@@@@@@@@@@@@@@@@@@@@@@@@@@
@@@@@@@@@@@@@@@@@@@@@@@@@@@@@@@@@
---------------------------------
@@@@@@@@@@@@@@@@@@@@@@@@@@@@@@@@@
@@@@@@@@@@@@@@@@@@@@@@@@@@@@@@@@@
        @@@@@@@@@@@@@@@@@@@@@@   
@       @()@  @@@@@@@@@@@@@@@@  @
@@       ~~   @     @     @@@@  @
@@       ~~   @  @  @  @   @@@@ @
@@@      ~~   @  @  @  @    @@  @
@@@      ~~      @     @     @  @
@@@@   @m~~m@@@@@@@@@@@@@@   @ @@
@@@@   @@ww@@@@@@@@@@@@@@@   @  @
@@@@@@@@@ww@@@@@@@@@@@@@@@      @
@@@@@@@@@ww@@@@@@@@@@@@@@@@@@@@@@
---------------------------------
    @@@@@@@             @@@@@@@@@
       @@@@@                   @@
         @@@@                    
           @@wwwwwwwwww@       @@
            @@@@@@@@@@@   @@@@@@@
                          @     @
^^^^^^^^^^^^^^^^^^^^^^@   @     @
EEEEEEEEEEEEEEEEE@@@@@@   @     @
EEEEEEEEEEEE@@@@@@@@@@    @     @
EEEEEEEE@@@@@                   @
EEEE@@@@@@@wwwwwwwwwwww@wwwwwwww@
EE@@@@@@@wwwwwwwwwwwwww@wwwwtwTw@
---------------------------------
