Oups tu glisses#MrPropre
---------------------------------
                                 
                O                
                                 
@@@@@                       @@@@@
(  )@                       @(  )
~~~~@                       @~~~~
~~~~@K                     K@~~~~
~~~~@                       @~~~~
~~~~@mm@@@@@@@@@@@@@@@@@@@mm@~~~~
@~~~                         ~~~@
~~~~                         ~~~~
wwwwwwwwwwwwwwwwwwwwwwwwwwwwwwwww
---------------------------------
@c@@@@@@@@@@@@@@@@@@@@@@v@@@@@@@@
     @@@@@@@@@@@@@@@@@@@c @@@@@@@
@     @@@@@@@@@@@@@@@@@          
@      @@@@@@@@@@@@@@@  @@@@@@@@@
@      @@@@@@@@@@@@@@@@   @   @ @
@@ @@@@@@@@@@@@@@@@@@@  @   @   @
@@ @@@@@@@@@@@@@@@@@@@@   @   @ @
@   @K     @@@@@@@@@@@@@@@@@@@@ @
@@ @m@        @@@@@@@@@@@@@@@@@ @
@@                              
@@@@@@@@   @@@@@@@@@@@@@@@@@@@@X@
@@@@@@@@www@@@@@@@@@@@@@@@@@@@@@@
---------------------------------
       @@@@@@@@@@@@@@@@@@@@@@@@@@
       @@@@@@@@@@@@@@@@@@@@      
               w       w        @
           @@  w@  @@  w@  w   @ 
           w       w          @  
@       @@@w@@@@@@@w@@@@@@@w@@   
  @                              
@   @  @                         
                                 
  @       @                      
@     @                          
       @                         
---------------------------------
  @@          @@@@@@@@@@@@@@@@@@@
              @@@@@@@@@@@@@@@@@@@
@@@@       @@@@@@@@@@@@@@@@@@@@@@
@@@@@   @     @@@@@@@@@@@@@@@@@@@
@           O @@@@@@@@@@@@@@@@@@@
@   @         @@@@@@@@@@@@@@@@@@@
@             @     @     @     @
@   m       ~ @  @  @  @  @  @  @
@           ~ @  @  @  @  @  @  @
@   @       ~    @     @     @   
@@@@@@@@@@@@~@@@@@@@@@@@@@@@@@@@@
@@@@@@@@@@@@w@@@@@@@@@@@@@@@@@@@@
---------------------------------
                  m              
                 m@m             
m   c         K@m @ m@K          
@             X@     @X          
@           @@@                  
                      @@@@@@@@@@@
     m@@@@@@@@         @SSSSSSSSS
         @SSS@@      @@Swwwwwwwww
WWWWWwwwwwwwSS@@@   @@Swwwwwwwwww
wtwwwwwwwwwwwwwSSSmSSSwwwwwwwwwww
wwwTwwwwwwwwwwwwwwwwwwwwwwwwwwwww
wwwwwwwwwwwwwwwwwwwwwwwwwwwwwwwww             
---------------------------------
                                 
                                 
         @@@@@@@@@@@@@@@@@@@@@@@@
                                @
                                @
                                @
                                @
                                @
                                @
                                @
 X X                            @
wXEXwwwwwwwwwwwwwwwwwwwww@@@@@@@@
---------------------------------
