Oups tu glisses#MrPropre
---------------------------------
                                 
                O                
                                 
@@@@@                       @@@@@
(  )@                       @(  )
~~~~@                       @~~~~
~~~~@                       @~~~~
~~~~@                       @~~~~
~~~~@mm@@@@@@@@@@@@@@@@@@@mm@~~~~
~~~~                         ~~~~
~~~~                         ~~~~
wwwwwwwwwwwwwwwwwwwwwwwwwwwwwwwww
---------------------------------
@c@@@@@@@@@@@@@@@@@@@@@@v@@@@@@@@
    @@@@@@@@@@@@@@@@@@@@c@@@@@@@@
@   @@@@@@@@@@@@@@@@@@@          
@      @@@@@@@@@@@@@@@  @@@@@@@@@
@      @@@@@@@@@@@@@@@@   @   @ @
@@ @@@@@@@@@@@@@@@@@@@  @   @   @
@@ @@@@@@@@@@@@@@@@@@@@   @   @ @
@   @@@@@@@@@@@@@@@@@@@@@@@@@@@ @
@@ @@@       @@@@@@@@@@@@@@@@@@ @
@@                               
@@@@@@@@   @@@@@@@@@@@@@@@@@@@@X@
@@@@@@@@www@@@@@@@@@@@@@@@@@@@@@@
---------------------------------
       @@@@@@@@@@@@@@@@@@@@@@@@@@
       @@@@@@@@@@@@@@@@@@@@      
       w       w       w        @
       w@  @@  w@  @@  w@      @ 
           w       w          @  
@   @@@@@@@w@@@@@@@w@@@@@@@@@@   
  @                              
@   @                            
    @                            
  @                              
@                                
                                 
---------------------------------
  @@          @@@@@@@@@@@@@@@@@@@
              @@@@@@@@@@@@@@@@@@@
@@@@          @@@@@@@@@@@@@@@@@@@
@@@@@         @@@@@@@@@@@@@@@@@@@
@           O @@@@@@@@@@@@@@@@@@@
@   @         @@@@@@@@@@@@@@@@@@@
@             @     @     @     @
@   m         @  @  @  @  @  @  @
@             @  @  @  @  @  @  @
@   @            @     @     @   
@@@@@@@@@@@@ @@@@@@@@@@@@@@@@@@@@
            w                    
---------------------------------
                                 
                                 
                                 
                                 
                                 
                              @@@
                            @@@@ 
       c        c         @@@@   
                        @@@@     
                     @@@@@       
                  @@@@@          
@@@@@@@@@@@@@@@@@@@@@            
---------------------------------
                                 
                                 
                                 
                                 
                                 
                                 
                                 
      @   @  @@@  @   @          
      @ @ @  @ @  @ @ @          
       @ @   @@@   @ @           
                                 
EEE@@@@@@@@@@@@@@@@@@@@@@@@@@@@@@
---------------------------------