OmniSkill#Laminor
---------------------------------
@   :@@@@@@@@@@@@@@@@@@@@@@@:   @
@   : @@@+   + @@@      @@@ :   @
@   : @@@@---@  :  @---@@@@ :   @
@   @ III    :  :  :    III @   @
@m    @@@  @@@  @  @@@  @@@    m@
@     @@@               @@@     @
  +   III    @--@--@   +III      
@@@@@@X@@@@@X@  C  @X@@@@@X@@@@@@
@@@@Q@@@@@@@@@     @@@@@@@@@+@@@@
@+@@X@@@@@@@Q@     @Q@@@@@@@X@@Q@
@X@@@@@@@@@@@@     @X@@@@@@@@@@X@
@@@@@@@@@@@@@@ mmm @@@@@@@@@@@@@@
---------------------------------
@@@@@@@@@@@@@@@@@@@@@@@@@@@@@@@@@
#   : #  F   #   F   # F H F #:  
  # :  # @#  +   @  Q  @ H @  :# 
    m    F   m # F #m  F m F  @  
 #  H  # @ # H   @  H #@ H @# H  
  + @    F   @  #F  @  F @ F #@  
@@@   #  @   H   @  H  @ H#@   # 
@@@ #   S----m      m----m  # @@@
@@@   # @   #   @-----@------m@@@
@@@     H#      H  #  ##   # v@@@
@@@ #   H     # H         #   @@@
@@@XXXXXXXXXXXXXXXXXXXXXXXXXXX@@@
---------------------------------
@@@@@@@@@@@@@@@@@@@@@@@@@@@@@@@@@
@@@@@@@@@@@@@@    K@K   @@@@@@@@@
@@@@@@@@@@@       X X    @@@@@@@@
@@@@@+@@@@   ~     mv     @@@@@@@
vv  @X@    A ~     c      @@@vvvv
     @   ~   ~                   
@@     A ~   ~       @@@@X@@@@@@@
@@       ~   ~       @@@@@@@@@@@@
         ~   ~      @@@Q@@@@@@@@@
@@m@@@@m@~@m@~@@ @@@@@@X@@@@+@@@@
@@@@@@@@@~@@@~ @ @@@@@@@@@@@X@@@@
@@@@@@@@wwwwwww@@@@@@@@@@@@@@@@@@
---------------------------------
@@@@@@@@@@@@@@@@ @@@@@@@@@@@@@@@@
@@@@@@@        @ @@@@@@@@@@@@@@@@
@@@@@@@        @ @@@@@@@@@@@@@@@@
      @        @ @@@@@@       @@@
               @ @@@@@         vv
@@@@@@         @ @@@@            
@@@@@@                @@m@@m@@m@@
@@@@@ K               @@ @@ @@ @@
@@@@@@mm@@@X                     
@@@@@@@@@@@@@@@ K @@@@@@m@@m@@m@@
@@@@@@@@@@@@@@@ m @@@@@@@@@@@@@@@
@@@@@@@@@@wwwwww@wwwwww@@@@@@@@@@
---------------------------------
          @                      
         K@K                     
         @@@                     
                                 
@@        @                      
@@        @             @@@     @
@@       !@!                    @
@@       vvv         @@@   @@@  @
@                               @
@  m@@@@@@ @@@@@@@@@@      @  @@@
@ww@@@@@     @@@@@@@@   XXX   @@@
@ww@@@@  mXm  @@@@@@@XXX@@@XXX@@@
---------------------------------
          @@@                    
           @@+++++++    @        
     O      @@@@@@@@^^^^@        
                   @@@@@@        
                               @@
                  @^^^^^^@@@@@@@@
       @^^^^^^^^^^@EEEEEE@@@@@@@@
^^^^^^^@EEEEEEEEEE@EEEE@@@@@@@@@@
EEEEEEE@EEEEEEEEEE@EEE@@@@@@@@@@@
EEEEEEE@EEEEEEEEEE@E@@@@@@@@@@@@@
EEEEEEE@EEEE@@@@@@@@@@@@@@@@@@@@@
EEEEEE@@@@@@@@@@@@@@@@@@@@@@@@@@@
---------------------------------
