Ricochet#Peartree
---------------------------------
@@@@@@@@@@@@@@@@@@@@@@@@@@@@@@@@@
@@@@@@@-----v---@---v-----@@@@@@@
@SS   @     *  O_   *     @   SS@
@  u  @u ~  @   C   @  ~ u@  u  @
@22@  @@ ~             ~ @@  @11@
@@@   @@m@             @m@@   @@@
@Kiii @ |~ @    m    @ ~| @ iiiK@
@qiii@@ |~ @  Ym@m L @ ~| @@iiiq@
@xxxxx: |~(Z) (ZZZ) (Z)~| :xxxxx@
@m@@@@X@@@@@@@@@X@@@@@@@@@X@@@@m@
@@@@@@@@@~@@@@@@@@@@@@@~@@@@@@@@@
wwwwwwwwwwwwwwwwwwwwwwwwwwwwwwwww
---------------------------------
