Waouuu#Monseigneur
---------------------------------
@@@@@@@@@@@@@@@@@@@@@@@@@@@@@@@@@
                                 
                                
                !                
               ! !                
!!!                           !!! 
@     !         !          !    @   
@    ! !                  ! !   @       
@                               @
@     !     @@@@ @@@@      !    @    
@        @@@@@@@@@@@@@@@        @
@@@@@@@@@@@@@@@@@@@@@@@@@@@@@@@@@
---------------------------------
@@@@@@@@@@@@@@@@@@@@@@@@@@@@@@@@@
@@@@@@@@@@@@@@@@@@@@@@@@@@@@@@@@@
                                 
                                 
                                 
             @  w  @                  
             w  @  w             
                w                
@@@@@@@@@@@@@@@@w@@@@@@@@@@@@@@@@
@@@@@@@@@@@@@@@@@@@@@@@@@@@@@@@@@
@@@@@@@@@@@@@@@@@@@@@@@@@@@@@@@@@
@@@@@@@@@@@@@@@@@@@@@@@@@@@@@@@@@
---------------------------------
@@@@@@@@@@@@@@@@@@@@@@@@@@@@@@@@@
@@@@@@@@@@@@@@@@@@@@@@@@@@@@@@@@@
                                 
                                 
              @ w @              
              w @ w              
              w @ w              
                w                
@@@@@@@@@@@@@@@@w@@@@@@@@@@@@@@@@
@@@@@@@@@@@@@@@@@@@@@@@@@@@@@@@@@
@@@@@@@@@@@@@@@@@@@@@@@@@@@@@@@@@
@@@@@@@@@@@@@@@@@@@@@@@@@@@@@@@@@
---------------------------------
@@@@@@@@@@@@@@@@@@@@@@@@@@@@@@@@@
@@@@@@@@@@@@@@@@@@@@@@@@@@@@@@@@@
                                 
                                 
                                 
                @                   
                w                   
                X                   
@@@@@@@@@@@@@@@@@@@@@@@@@@@@@@@@@
@@@@@@@@@@@@@@@@@@@@@@@@@@@@@@@@@
@@@@@@@@@@@@@@@@@@@@@@@@@@@@@@@@@
@@@@@@@@@@@@@@@@@@@@@@@@@@@@@@@@@
---------------------------------
@@@@@@@@@@@@@@@@*@@@@@@@@@@@@@@@@
@@@@@@@@@@@@@@@@X@@@@@@@@@@@@@@@@
            @@@@@@@@@                
            @  @ @  @               
            @       @              
          @*          @               
          @           @                
          @ K      K  @               
@@@@@@@@@@@m!!m ! m!!mm@@@@@@@@@@
@@@@@@@@@@@@@@@w@w@@@@@@@@@@@@@@@
@@@@@@@@@@@@@@@m@m@@@@@@@@@@@@@@@
@@@@@@@@@@@@@@@@@@@@@@@@@@@@@@@@@
---------------------------------
@@@@@@@@@@@@@@@@@@@@@@@@@@@@@@@@@
@@@@@@@@@@@@@@@@@@@@@@@@@@@@@@@@@
                                E 
                                w 
                                E 
                                w 
                                E 
                                w 
                                E 
                                w 
                                E 
                                w 
---------------------------------
